1111111111111
1E00001111101
1000000010011
1000C01111101
1000000000001
1000000000001
1000000010001
10000001C1001
1000000010001
1000000000001
1000000000001
10000000000P1
1111111111111