111111
10C001
100E01
1000P1
111111