11111111111111111111
1000000000P000000001
10000000000000000001
10000000000000000001
10000000000000000001
10111111111111100001
100000000000000000C1
10000000000000000001
10000C00000000000001
10000000000001110001
10000000000000E00001
11111111111111111111